11111111111111111111111111111111111111111111111111111111111111111111111111111111
10000000000000000000000000000000000000011100000000000000000000000000000000000001
10000000000000000000000000000000000000000000000000000000000000000000000000000001
10000000000000000000000000000000000000000000000000000000000000000000000000000001
11110000000000000000000000000000000000000000000000000000000000000000000000001111
10000000000000000000000000000000000000000000000000000000000000000000000000000001
10000000000000000000000000000000000000001000000000000000000000000000000000000001
10000000000000000000000000000000000000011100000000000000000000000000000000000001
10000000000000000000000000000000000000111110000000000000000000000000000000000001
10000000000000000000000000000000000001111111000000000000000000000000000000000001
10000000000000000000000000000000000011111111100000000000000000000000000000000001
10000000000000000000000000000000000001111111000000000000000000000000000000000001
10000000000000000000000000000000000000111110000000000000000000000000000000000001
11110000000000000000000000000000000000011100000000000000000000000000000000001111
10000000000000000000000000000000000000001000000000000000000000000000000000000001
10000000000000010000000000000000000000000000000000000000000000010000000000000001
10000000000000111000000000000000000000000000000000000000000000111000000000000001
10000000000000010000000000000000000000000000000000000000000000010000000000000001
10000000000000000000000000000000000000000000000000000000000000000000000000000001
11000000000000000000000000000000000000000000000000000000000000000000000000000011
11100000000000000000000000000000000000011100000000000000000000000000000000000111
11111111111111111111111111111111111111111111111111111111111111111111111111111111